
 8 0 0 1 0 1 0 0 1 0 0 1 0 0 1 3 
 8 0 0 1 0 1 0 0 1 0 0 1 0 0 1 0 
 8 1 0 1 0 1 0 0 1 0 0 1 0 0 1 0 
 8 1 0 0 0 1 0 0 1 0 0 1 0 0 1 0 
 8 0 0 1 0 1 0 0 0 0 0 1 1 0 1 0 
 8 0 1 1 0 1 1 1 0 1 0 1 0 0 1 0 
 8 0 0 1 0 1 0 0 0 1 0 1 0 0 1 0 
 8 0 0 1 0 0 0 0 0 1 0 1 0 0 1 0 
 8 0 0 1 0 0 0 0 0 1 0 0 0 0 1 0 
 8 0 0 1 0 1 0 0 0 1 0 0 0 0 1 0 
 8 0 0 1 0 1 0 0 0 1 1 1 1 0 1 0 
 8 0 0 1 0 1 0 0 0 1 0 0 0 0 1 0 
 8 0 1 1 0 1 0 0 0 1 0 0 0 0 0 0 
 8 0 2 1 0 1 0 0 0 1 0 0 1 0 1 0 
 8 0 0 0 0 0 0 0 0 0 0 0 0 0 0 0 
 8 8 8 8 8 8 8 8 8 8 8 8 8 8 8 8
